1 13 31
vvvvvvvvvvvvvvvvvvvvvvvvvvvvvvv
###############################
#p   s f  *  1 * 2 *  * * *   #
# x*  b  s  *     1   * 2 * * #
#s#                     # # #*#
#       3  x **  *  *   1     #
#                         # # #
#*  *                *        #
# #                   # # # # #
#*    **  *       *           #
# #*# # # # # # #*# # # # # # #
#           *   *  *          #
###############################


